date,symbol,reportedCurrency,cik,fillingDate,acceptedDate,calendarYear,period,revenue,costOfRevenue,grossProfit,grossProfitRatio,researchAndDevelopmentExpenses,generalAndAdministrativeExpenses,sellingAndMarketingExpenses,sellingGeneralAndAdministrativeExpenses,otherExpenses,operatingExpenses,costAndExpenses,interestIncome,interestExpense,depreciationAndAmortization,ebitda,ebitdaratio,operatingIncome,operatingIncomeRatio,totalOtherIncomeExpensesNet,incomeBeforeTax,incomeBeforeTaxRatio,incomeTaxExpense,netIncome,netIncomeRatio,eps,epsdiluted,weightedAverageShsOut,weightedAverageShsOutDil,link,finalLink
2023-03-25,PEP,USD,0000077476,2023-04-25,2023-04-24 17:57:25,2023,Q1,17846000000,7988000000,9858000000,0.552392693,0,0,0,7229000000,0,7229000000,15217000000,0,200000000,767000000,3396000000,0.1902947439,2629000000,0.1473159251,-139000000,2490000000,0.1395270649,546000000,1932000000,0.108259554,1.4,1.4,1378000000,1384000000,https://www.sec.gov/Archives/edgar/data/77476/000007747623000023/0000077476-23-000023-index.htm,https://www.sec.gov/Archives/edgar/data/77476/000007747623000023/pep-20230325.htm
2022-12-31,PEP,USD,0000077476,2023-02-09,2023-02-08 18:06:37,2022,Q4,27996000000,13420000000,14576000000,0.5206458065,0,0,0,12197000000,0,12197000000,25617000000,0,273000000,1080000000,2343000000,0.0836905272,1263000000,0.0451135877,-757000000,506000000,0.0180740106,-29000000,518000000,0.0185026432,0.38,0.37,1377000000,1385000000,https://www.sec.gov/Archives/edgar/data/77476/000007747623000007/0000077476-23-000007-index.htm,https://www.sec.gov/Archives/edgar/data/77476/000007747623000007/pep-20221231.htm
2022-09-03,PEP,USD,0000077476,2022-10-12,2022-10-11 17:56:11,2022,Q3,21971000000,10308000000,11663000000,0.5308361021,0,0,0,8295000000,0,8295000000,18603000000,0,190000000,833000000,4186000000,0.1905238724,3353000000,0.152610259,-154000000,3199000000,0.1456010195,475000000,2702000000,0.1229802922,1.96,1.95,1380000000,1387000000,https://www.sec.gov/Archives/edgar/data/77476/000007747622000052/0000077476-22-000052-index.htm,https://www.sec.gov/Archives/edgar/data/77476/000007747622000052/pep-20220903.htm
2022-06-11,PEP,USD,0000077476,2022-07-12,2022-07-11 17:56:41,2022,Q2,20225000000,9415000000,10810000000,0.534487021,0,0,0,7387000000,0,7387000000,16802000000,0,236000000,760000000,4181000000,0.2067243511,3421000000,0.1691470952,-1582000000,1839000000,0.0909270705,393000000,1429000000,0.0706551298,1.03,1.03,1382000000,1389000000,https://www.sec.gov/Archives/edgar/data/77476/000007747622000043/0000077476-22-000043-index.htm,https://www.sec.gov/Archives/edgar/data/77476/000007747622000043/pep-20220611.htm
2022-03-19,PEP,USD,0000077476,2022-04-26,2022-04-25 17:51:15,2022,Q1,16200000000,7433000000,8767000000,0.5411728395,0,0,0,6822000000,0,6822000000,14255000000,0,240000000,658000000,2737000000,0.1689506173,2079000000,0.1283333333,3082000000,5161000000,0.3185802469,888000000,4261000000,0.2630246914,3.08,3.06,1383000000,1391000000,https://www.sec.gov/Archives/edgar/data/77476/000007747622000020/0000077476-22-000020-index.htm,https://www.sec.gov/Archives/edgar/data/77476/000007747622000020/pep-20220319.htm
2021-12-25,PEP,USD,0000077476,2022-02-10,2022-02-09 18:03:39,2021,Q4,25248000000,12130000000,13118000000,0.5195659062,0,0,0,10556000000,0,10556000000,22686000000,0,1132000000,1491000000,4053000000,0.1605275665,2562000000,0.101473384,-974000000,1588000000,0.062896071,247000000,1341000000,0.0531131179,0.97,0.96,1383000000,1390000000,https://www.sec.gov/Archives/edgar/data/77476/000007747622000010/0000077476-22-000010-index.htm,https://www.sec.gov/Archives/edgar/data/77476/000007747622000010/pep-20211225.htm
2021-09-04,PEP,USD,0000077476,2021-10-05,2021-10-04 17:41:11,2021,Q3,20189000000,9394000000,10795000000,0.5346971123,0,0,0,7636000000,0,7636000000,17030000000,0,232000000,749000000,3908000000,0.1935707564,3159000000,0.1564713458,-114000000,3045000000,0.1508247065,802000000,2224000000,0.1101589975,1.61,1.6,1382000000,1389000000,https://www.sec.gov/Archives/edgar/data/77476/000007747621000050/0000077476-21-000050-index.htm,https://www.sec.gov/Archives/edgar/data/77476/000007747621000050/pep-20210904.htm
2021-06-12,PEP,USD,0000077476,2021-07-13,2021-07-12 17:37:10,2021,Q2,19217000000,8880000000,10337000000,0.5379091429,0,0,0,7208000000,0,7208000000,16088000000,0,241000000,765000000,3894000000,0.2026330853,3129000000,0.1628245824,-115000000,3014000000,0.1568402977,642000000,2358000000,0.122703856,1.71,1.7,1382000000,1388000000,https://www.sec.gov/Archives/edgar/data/77476/000007747621000039/0000077476-21-000039-index.htm,https://www.sec.gov/Archives/edgar/data/77476/000007747621000039/pep-20210612.htm
2021-03-20,PEP,USD,0000077476,2021-04-15,2021-04-14 17:37:04,2021,Q1,14820000000,6671000000,8149000000,0.5498650472,0,0,0,5837000000,0,5837000000,12508000000,0,258000000,671000000,2983000000,0.2012820513,2312000000,0.1560053981,-138000000,2174000000,0.1466936572,451000000,1714000000,0.1156545209,1.24,1.24,1380000000,1387000000,https://www.sec.gov/Archives/edgar/data/77476/000007747621000018/0000077476-21-000018-index.htm,https://www.sec.gov/Archives/edgar/data/77476/000007747621000018/pep-20210320.htm
2020-12-26,PEP,USD,0000077476,2021-02-11,2021-02-10 17:41:49,2020,Q4,22455000000,10426000000,12029000000,0.5356936094,0,0,0,9203000000,0,9203000000,19629000000,0,339000000,673000000,3499000000,0.1558227566,2826000000,0.1258517034,-469000000,2357000000,0.1049654865,498000000,1845000000,0.0821643287,1.34,1.33,1380000000,1388000000,https://www.sec.gov/Archives/edgar/data/77476/000007747621000007/0000077476-21-000007-index.htm,https://www.sec.gov/Archives/edgar/data/77476/000007747621000007/pep-20201226.htm
2020-09-05,PEP,USD,0000077476,2020-10-01,2020-09-30 17:42:34,2020,Q3,18091000000,8156000000,9935000000,0.5491680946,0,0,0,6924000000,0,6924000000,15080000000,0,264000000,679000000,3690000000,0.2039688243,3011000000,0.1664363496,-178000000,2833000000,0.156597203,526000000,2291000000,0.1266375546,1.66,1.65,1383000000,1390000000,https://www.sec.gov/Archives/edgar/data/77476/000007747620000068/0000077476-20-000068-index.htm,https://www.sec.gov/Archives/edgar/data/77476/000007747620000068/pep-20200905.htm
2020-06-13,PEP,USD,0000077476,2020-07-13,2020-07-13 06:03:55,2020,Q2,15945000000,7088000000,8857000000,0.5554719348,0,0,0,6538000000,0,6538000000,13626000000,0,235000000,661000000,2980000000,0.1868924428,2319000000,0.1454374412,-151000000,2168000000,0.1359673879,510000000,1646000000,0.1032298526,1.19,1.18,1387000000,1393000000,https://www.sec.gov/Archives/edgar/data/77476/000007747620000060/0000077476-20-000060-index.htm,https://www.sec.gov/Archives/edgar/data/77476/000007747620000060/pepsicoq2-10xq2020.htm
2020-03-21,PEP,USD,0000077476,2020-04-28,2020-04-28 06:03:50,2020,Q1,13881000000,6125000000,7756000000,0.5587493696,0,5707000000,123000000,5830000000,8000000,5838000000,11963000000,0,290000000,597000000,2521000000,0.1816151574,1924000000,0.1386067286,-213000000,1711000000,0.1232620128,360000000,1338000000,0.0963907499,0.96,0.96,1390000000,1396000000,https://www.sec.gov/Archives/edgar/data/77476/000007747620000041/0000077476-20-000041-index.htm,https://www.sec.gov/Archives/edgar/data/77476/000007747620000041/pepsicoq1-10xq2020.htm
2019-12-28,PEP,USD,0000077476,2020-02-13,2020-02-13 06:09:23,2019,Q4,20640000000,9331000000,11309000000,0.5479166667,0,8555000000,40000000,8595000000,17000000,8612000000,17943000000,61000000,345000000,619000000,3318000000,0.160755814,2699000000,0.1307655039,-491000000,2208000000,0.1069767442,409000000,1766000000,0.0855620155,1.27,1.26,1391000000,1401000000,https://www.sec.gov/Archives/edgar/data/77476/000007747620000015/0000077476-20-000015-index.htm,https://www.sec.gov/Archives/edgar/data/77476/000007747620000015/pepsico201910-k.htm
2019-09-07,PEP,USD,0000077476,2019-10-03,2019-10-03 06:03:29,2019,Q3,17188000000,7684000000,9504000000,0.5529439144,0,6547000000,92000000,6639000000,15000000,6654000000,14338000000,38000000,262000000,644000000,3499000000,0.2035722597,2855000000,0.1661042588,-186000000,2669000000,0.1552827554,559000000,2100000000,0.1221782639,1.5,1.49,1397000000,1405000000,https://www.sec.gov/Archives/edgar/data/77476/000007747619000093/0000077476-19-000093-index.htm,https://www.sec.gov/Archives/edgar/data/77476/000007747619000093/pepsicoq3-10xq2019.htm
2019-06-15,PEP,USD,0000077476,2019-07-09,2019-07-09 06:07:54,2019,Q2,16449000000,7302000000,9147000000,0.5560824366,0,6210000000,106000000,6316000000,102000000,6418000000,13720000000,38000000,261000000,649000000,3378000000,0.2053620281,2729000000,0.1659067421,-162000000,2567000000,0.156058119,524000000,2035000000,0.1237157274,1.45,1.44,1399000000,1409000000,https://www.sec.gov/Archives/edgar/data/77476/000007747619000070/0000077476-19-000070-index.htm,https://www.sec.gov/Archives/edgar/data/77476/000007747619000070/pepsicoq2-10xq2019.htm
2019-03-23,PEP,USD,0000077476,2019-04-17,2019-04-17 06:03:08,2019,Q1,12884000000,5666000000,7218000000,0.5602297423,0,5208000000,-20000000,5188000000,17000000,5205000000,10871000000,63000000,267000000,645000000,2653000000,0.2059143123,2008000000,0.1558522198,-140000000,1868000000,0.1449860292,475000000,1413000000,0.1096709097,1.01,1.0,1406000000,1413000000,https://www.sec.gov/Archives/edgar/data/77476/000007747619000038/0000077476-19-000038-index.htm,https://www.sec.gov/Archives/edgar/data/77476/000007747619000038/pepsicoq1-10xq2019.htm
2018-12-29,PEP,USD,0000077476,2019-02-15,2019-02-15 16:23:02,2018,Q4,19524000000,8933000000,10591000000,0.5424605614,0,7887000000,270000000,8157000000,3000000,8160000000,17093000000,58000000,621000000,1632000000,4188000000,0.2145052243,2556000000,0.1309157959,-621000000,1935000000,0.0991087892,-4050000000,6854000000,0.3510551117,4.86,4.83,1410000000,1420000000,https://www.sec.gov/Archives/edgar/data/77476/000007747619000017/0000077476-19-000017-index.htm,https://www.sec.gov/Archives/edgar/data/77476/000007747619000017/pepsico201810-k.htm
2018-09-08,PEP,USD,0000077476,2018-10-02,2018-10-02 16:20:04,2018,Q3,16485000000,7527000000,8958000000,0.5434030937,0,6068000000,46000000,6114000000,0,6114000000,13641000000,81000000,302000000,634000000,3478000000,0.2109796785,2844000000,0.1725204732,-147000000,2697000000,0.1636032757,112000000,2498000000,0.1515316955,1.77,1.75,1414000000,1424000000,https://www.sec.gov/Archives/edgar/data/77476/000007747618000076/0000077476-18-000076-index.htm,https://www.sec.gov/Archives/edgar/data/77476/000007747618000076/pepsicoq3-10xq982018.htm
2018-06-16,PEP,USD,0000077476,2018-07-10,2018-07-10 16:17:24,2018,Q2,16090000000,7263000000,8827000000,0.5486016159,0,5758000000,41000000,5799000000,0,5799000000,13062000000,98000000,308000000,-33000000,2995000000,0.1861404599,3028000000,0.1881914232,-128000000,2900000000,0.1802361715,293000000,1820000000,0.1620261032,1.84,1.83,1417000000,1426000000,https://www.sec.gov/Archives/edgar/data/77476/000007747618000055/0000077476-18-000055-index.htm,https://www.sec.gov/Archives/edgar/data/77476/000007747618000055/pepsicoq2-10xq6162018.htm
2018-03-24,PEP,USD,0000077476,2018-04-26,2018-04-26 16:22:42,2018,Q1,12562000000,5655000000,6907000000,0.5498328292,0,5104000000,-4000000,5100000000,0,5100000000,10755000000,69000000,294000000,629000000,2436000000,0.1939181659,1807000000,0.1438465213,-150000000,1657000000,0.1319057475,303000000,1343000000,0.1069097278,0.95,0.94,1419000000,1430000000,https://www.sec.gov/Archives/edgar/data/77476/000007747618000032/0000077476-18-000032-index.htm,https://www.sec.gov/Archives/edgar/data/77476/000007747618000032/pepsicoq1-10xq3242018.htm
2017-12-30,PEP,USD,0000077476,2018-02-13,2018-02-13 16:32:31,2017,Q4,19526000000,9079000000,10447000000,0.5350302161,0,7732000000,169000000,7901000000,-24000000,7877000000,16956000000,103000000,365000000,-1626000000,946000000,0.0484482229,2572000000,0.1317218068,-241000000,2331000000,0.1193792892,526000000,1805000000,0.0924408481,1.27,1.27,1420000000,1421000000,https://www.sec.gov/Archives/edgar/data/77476/000007747618000012/0000077476-18-000012-index.htm,https://www.sec.gov/Archives/edgar/data/77476/000007747618000012/pepsico201710-k.htm
2017-09-09,PEP,USD,0000077476,2017-10-04,2017-10-04 16:26:06,2017,Q3,16240000000,7368000000,8872000000,0.5463054187,0,5926000000,-61000000,5865000000,83000000,5948000000,13316000000,52000000,269000000,613000000,3606000000,0.222044335,2993000000,0.1842980296,-217000000,2776000000,0.1709359606,620000000,2144000000,0.1320197044,1.5,1.49,1425000000,1438000000,https://www.sec.gov/Archives/edgar/data/77476/000007747617000048/0000077476-17-000048-index.htm,https://www.sec.gov/Archives/edgar/data/77476/000007747617000048/pepsicoq3-10xq992017.htm
2017-06-17,PEP,USD,0000077476,2017-07-11,2017-07-11 16:19:57,2017,Q2,15710000000,7056000000,8654000000,0.5508593253,0,5621000000,27000000,5648000000,16000000,5664000000,12720000000,49000000,265000000,590000000,3580000000,0.227880331,2990000000,0.190324634,-216000000,2774000000,0.1765754297,656000000,2105000000,0.1339910885,1.47,1.46,1428000000,1441000000,https://www.sec.gov/Archives/edgar/data/77476/000007747617000033/0000077476-17-000033-index.htm,https://www.sec.gov/Archives/edgar/data/77476/000007747617000033/pepsicoq2-10xq6172017.htm
2017-03-25,PEP,USD,0000077476,2017-04-26,2017-04-26 16:24:16,2017,Q1,12049000000,5290000000,6759000000,0.5609594157,0,4875000000,-58000000,4817000000,79000000,4896000000,10186000000,40000000,252000000,506000000,2439000000,0.2024234376,1933000000,0.1604282513,-212000000,1721000000,0.1428334302,392000000,1318000000,0.1093866711,0.92,0.91,1428000000,1440000000,https://www.sec.gov/Archives/edgar/data/77476/000007747617000017/0000077476-17-000017-index.htm,https://www.sec.gov/Archives/edgar/data/77476/000007747617000017/pepsicoq1-10xq3252017.htm
2016-12-31,PEP,USD,0000077476,2017-02-15,2017-02-15 16:35:15,2016,Q4,19515000000,8944000000,10571000000,0.5416858827,0,8169000000,0,8169000000,21000000,8190000000,17134000000,44000000,594000000,785000000,3166000000,0.1622341788,2381000000,0.1220087112,-550000000,1831000000,0.0938252626,414000000,1401000000,0.0717909301,0.98,0.97,1428000000,1444000000,https://www.sec.gov/Archives/edgar/data/77476/000007747617000010/0000077476-17-000010-index.htm,https://www.sec.gov/Archives/edgar/data/77476/000007747617000010/pepsico201610-k.htm
2016-09-03,PEP,USD,0000077476,2016-09-29,2016-09-29 16:20:07,2016,Q3,16027000000,7284000000,8743000000,0.5455169402,0,5855000000,49000000,5904000000,18000000,5922000000,13206000000,30000000,247000000,585000000,3406000000,0.2125163786,2821000000,0.1760154739,-217000000,2604000000,0.1624758221,600000000,1992000000,0.1242902602,1.38,1.37,1438000000,1452000000,https://www.sec.gov/Archives/edgar/data/77476/000007747616000107/0000077476-16-000107-index.htm,https://www.sec.gov/Archives/edgar/data/77476/000007747616000107/pepsicoq3-10xq932016.htm
2016-06-11,PEP,USD,0000077476,2016-07-07,2016-07-07 16:20:31,2016,Q2,15395000000,6830000000,8565000000,0.5563494641,0,5530000000,54000000,5584000000,17000000,5601000000,12431000000,22000000,255000000,577000000,3541000000,0.2300097434,2964000000,0.1925300422,-233000000,2731000000,0.1773952582,718000000,2005000000,0.13023709,1.39,1.38,1443000000,1456000000,https://www.sec.gov/Archives/edgar/data/77476/000007747616000094/0000077476-16-000094-index.htm,https://www.sec.gov/Archives/edgar/data/77476/000007747616000094/pepsicoq2-10xq6112016.htm
2016-03-19,PEP,USD,0000077476,2016-04-18,2016-04-18 16:09:39,2016,Q1,11862000000,5151000000,6711000000,0.5657561963,0,5015000000,63000000,5078000000,14000000,5092000000,10243000000,14000000,246000000,481000000,2100000000,0.177035913,1619000000,0.1364862586,-232000000,1387000000,0.1169280054,442000000,931000000,0.0784859214,0.64,0.64,1446000000,1459000000,https://www.sec.gov/Archives/edgar/data/77476/000007747616000074/0000077476-16-000074-index.htm,https://www.sec.gov/Archives/edgar/data/77476/000007747616000074/pepsicoq1-10xq3192016.htm
2015-12-26,PEP,USD,0000077476,2016-02-11,2016-02-11 16:40:10,2015,Q4,18585000000,8727000000,9858000000,0.5304277643,0,7481000000,462000000,7943000000,-325000000,7618000000,16345000000,28000000,317000000,785000000,3025000000,0.1627656712,2240000000,0.120527307,-289000000,1951000000,0.1049771321,218000000,1718000000,0.0924401399,1.19,1.17,1448000000,1470000000,https://www.sec.gov/Archives/edgar/data/77476/000007747616000066/0000077476-16-000066-index.htm,https://www.sec.gov/Archives/edgar/data/77476/000007747616000066/pepsico201510-k.htm
2015-09-05,PEP,USD,0000077476,2015-10-06,2015-10-06 16:17:55,2015,Q3,16331000000,7490000000,8841000000,0.5413630519,0,6024000000,119000000,6143000000,1282000000,7425000000,14915000000,2000000,225000000,561000000,1977000000,0.1210581103,1416000000,0.0867062642,-223000000,1193000000,0.0730512522,650000000,533000000,0.0326373155,0.36,0.36,1467000000,1483000000,https://www.sec.gov/Archives/edgar/data/77476/000007747615000050/0000077476-15-000050-index.htm,https://www.sec.gov/Archives/edgar/data/77476/000007747615000050/pepsicoq3-10xq952015.htm
2015-06-13,PEP,USD,0000077476,2015-07-09,2015-07-09 16:16:58,2015,Q2,15923000000,7251000000,8672000000,0.5446209885,0,5704000000,133000000,5837000000,-65000000,5772000000,13023000000,14000000,217000000,579000000,3479000000,0.2184889782,2900000000,0.1821264837,-203000000,2697000000,0.1693776298,703000000,1980000000,0.1243484268,1.34,1.33,1476000000,1491000000,https://www.sec.gov/Archives/edgar/data/77476/000007747615000036/0000077476-15-000036-index.htm,https://www.sec.gov/Archives/edgar/data/77476/000007747615000036/pepsicoq2-10xq6132015.htm
2015-03-21,PEP,USD,0000077476,2015-04-23,2015-04-23 16:25:27,2015,Q1,12217000000,5503000000,6714000000,0.5495620856,0,4873000000,89000000,4962000000,-45000000,4917000000,10420000000,15000000,211000000,501000000,2298000000,0.1880985512,1797000000,0.1470901203,-196000000,1601000000,0.1310469019,370000000,1221000000,0.0999427028,0.83,0.81,1479000000,1503000000,https://www.sec.gov/Archives/edgar/data/77476/000007747615000021/0000077476-15-000021-index.htm,https://www.sec.gov/Archives/edgar/data/77476/000007747615000021/pepsicoq1-10xq3212015.htm
2014-12-27,PEP,USD,0000077476,2015-02-12,2015-02-12 17:01:46,2014,Q4,19948000000,9718000000,10230000000,0.5128333668,0,8012000000,514000000,8526000000,-327000000,8199000000,17917000000,34000000,284000000,850000000,2881000000,0.1444255063,2031000000,0.1018147183,-250000000,1781000000,0.0892821335,455000000,1311000000,0.0657208743,0.88,0.87,1488000000,1514000000,https://www.sec.gov/Archives/edgar/data/77476/000007747615000012/0000077476-15-000012-index.htm,https://www.sec.gov/Archives/edgar/data/77476/000007747615000012/pepsico201410-k.htm
2014-09-06,PEP,USD,0000077476,2014-10-09,2014-10-09 16:19:24,2014,Q3,17218000000,7995000000,9223000000,0.5356603554,0,6284000000,70000000,6354000000,22000000,6376000000,14371000000,23000000,215000000,645000000,3492000000,0.2028110117,2847000000,0.1653502149,-192000000,2655000000,0.154199094,637000000,2008000000,0.1166221396,1.33,1.32,1507000000,1525000000,https://www.sec.gov/Archives/edgar/data/77476/000007747614000057/0000077476-14-000057-index.htm,https://www.sec.gov/Archives/edgar/data/77476/000007747614000057/pepsicoq3-10xq962014.htm
2014-06-14,PEP,USD,0000077476,2014-07-23,2014-07-23 16:25:57,2014,Q2,16894000000,7778000000,9116000000,0.5395998579,0,6090000000,108000000,6198000000,22000000,6220000000,13998000000,18000000,209000000,639000000,3535000000,0.2092458861,2896000000,0.1714218066,-191000000,2705000000,0.1601160175,718000000,1978000000,0.117082988,1.3,1.29,1515000000,1532000000,https://www.sec.gov/Archives/edgar/data/77476/000007747614000044/0000077476-14-000044-index.htm,https://www.sec.gov/Archives/edgar/data/77476/000007747614000044/pepsicoq2-10xq6142014.htm
2014-03-22,PEP,USD,0000077476,2014-04-17,2014-04-17 16:16:17,2014,Q1,12623000000,5747000000,6876000000,0.5447199556,0,4967000000,81000000,5048000000,21000000,5069000000,10816000000,10000000,201000000,531000000,2338000000,0.1852174602,1807000000,0.1431513903,-191000000,1616000000,0.1280202804,389000000,1216000000,0.0963320922,0.8,0.79,1519000000,1540000000,https://www.sec.gov/Archives/edgar/data/77476/000007747614000025/0000077476-14-000025-index.htm,https://www.sec.gov/Archives/edgar/data/77476/000007747614000025/pepsicoq1-10xq3222014.htm
2013-12-28,PEP,USD,0000077476,2014-02-14,2014-02-14 16:26:07,2013,Q4,20118000000,9524000000,10594000000,0.5265931007,0,7999000000,121000000,8120000000,76000000,8196000000,17720000000,35000000,269000000,871000000,3269000000,0.1624913013,2398000000,0.1191967392,-234000000,2164000000,0.1075653644,410000000,1742000000,0.0865891242,1.14,1.12,1529000000,1552000000,https://www.sec.gov/Archives/edgar/data/77476/000007747614000007/0000077476-14-000007-index.htm,https://www.sec.gov/Archives/edgar/data/77476/000007747614000007/pepsico201310-k.htm
2013-09-07,PEP,USD,0000077476,2013-10-16,2013-10-16 16:24:43,2013,Q3,16909000000,7899000000,9010000000,0.5328523272,0,6148000000,10000000,6158000000,72000000,6230000000,14129000000,17000000,220000000,637000000,3417000000,0.2020817316,2780000000,0.1644094861,-203000000,2577000000,0.1524040452,654000000,1913000000,0.1131350169,1.24,1.23,1537000000,1561000000,https://www.sec.gov/Archives/edgar/data/77476/000007747613000027/0000077476-13-000027-index.htm,https://www.sec.gov/Archives/edgar/data/77476/000007747613000027/pepsicoq3-10xq972013.htm
2013-06-15,PEP,USD,0000077476,2013-07-24,2013-07-24 16:19:52,2013,Q2,16807000000,7898000000,8909000000,0.5300767537,0,5995000000,18000000,6013000000,27000000,6040000000,13938000000,18000000,208000000,637000000,3506000000,0.208603558,2869000000,0.1707026834,-190000000,2679000000,0.1593978699,654000000,2010000000,0.1195930267,1.3,1.28,1548000000,1567000000,https://www.sec.gov/Archives/edgar/data/77476/000007747613000020/0000077476-13-000020-index.htm,https://www.sec.gov/Archives/edgar/data/77476/000007747613000020/pepsicoq2-10xq6152013.htm
2013-03-23,PEP,USD,0000077476,2013-04-19,2013-04-19 16:17:42,2013,Q1,12581000000,5834000000,6747000000,0.536284874,0,5054000000,12000000,5066000000,23000000,5089000000,10923000000,27000000,214000000,568000000,2226000000,0.1769334711,1658000000,0.1317860265,-187000000,1471000000,0.1169223432,386000000,1075000000,0.0854463079,0.7,0.69,1545000000,1563000000,https://www.sec.gov/Archives/edgar/data/77476/000007747613000008/0000077476-13-000008-index.htm,https://www.sec.gov/Archives/edgar/data/77476/000007747613000008/pepsicoq1-10xq3232013.htm
2012-12-29,PEP,USD,0000077476,2013-02-21,2013-02-21 16:46:15,2012,Q4,19954000000,9654000000,10300000000,0.5161872306,0,8050000000,0,8050000000,37000000,8087000000,17741000000,44000000,288000000,890000000,3103000000,0.1555076676,2213000000,0.1109050817,-244000000,1969000000,0.098676957,302000000,1661000000,0.0832414553,1.08,1.06,1544000000,1564000000,https://www.sec.gov/Archives/edgar/data/77476/000144530513000278/0001445305-13-000278-index.htm,https://www.sec.gov/Archives/edgar/data/77476/000144530513000278/pepsico201210-k.htm
2012-09-08,PEP,USD,0000077476,2012-10-17,2012-10-17 17:09:32,2012,Q3,16652000000,7833000000,8819000000,0.5296060533,0,5953000000,39000000,5992000000,27000000,6019000000,13852000000,23000000,204000000,648000000,3448000000,0.2070622147,2800000000,0.1681479702,-181000000,2619000000,0.157278405,706000000,1902000000,0.1142205141,1.22,1.21,1556000000,1575000000,https://www.sec.gov/Archives/edgar/data/77476/000144530512003144/0001445305-12-003144-index.htm,https://www.sec.gov/Archives/edgar/data/77476/000144530512003144/pepsicoq3-10xq982012.htm
2012-06-16,PEP,USD,0000077476,2012-07-25,2012-07-25 17:20:42,2012,Q2,16458000000,7915000000,8543000000,0.5190788674,0,5864000000,272000000,6136000000,30000000,6166000000,14081000000,1000000,209000000,634000000,3011000000,0.1829505408,2377000000,0.1444282416,-208000000,2169000000,0.1317900109,668000000,1488000000,0.0904119577,0.95,0.94,1563000000,1581000000,https://www.sec.gov/Archives/edgar/data/77476/000119312512314695/0001193125-12-314695-index.htm,https://www.sec.gov/Archives/edgar/data/77476/000119312512314695/d368585d10q.htm
2012-03-24,PEP,USD,0000077476,2012-04-26,2012-04-26 16:27:36,2012,Q1,12428000000,5889000000,6539000000,0.5261506276,0,4824000000,-32000000,4792000000,25000000,4817000000,10706000000,23000000,198000000,572000000,2294000000,0.1845831992,1722000000,0.1385580946,-175000000,1547000000,0.1244769874,414000000,1127000000,0.0906823302,0.72,0.71,1568000000,1584000000,https://www.sec.gov/Archives/edgar/data/77476/000119312512186092/0001193125-12-186092-index.htm,https://www.sec.gov/Archives/edgar/data/77476/000119312512186092/d320879d10q.htm
2011-12-31,PEP,USD,0000077476,2012-02-27,2012-02-27 16:50:56,2011,Q4,20158000000,9731000000,10427000000,0.5172636174,0,8150000000,0,8150000000,30000000,8180000000,17911000000,24000000,272000000,897000000,3144000000,0.155967854,2247000000,0.1114693918,-248000000,1999000000,0.099166584,597000000,1415000000,0.0701954559,0.9,0.89,1576000000,1584000000,https://www.sec.gov/Archives/edgar/data/77476/000119312512081822/0001193125-12-081822-index.htm,https://www.sec.gov/Archives/edgar/data/77476/000119312512081822/d269581d10k.htm
2011-09-03,PEP,USD,0000077476,2011-10-12,2011-10-12 16:19:47,2011,Q3,17582000000,8452000000,9130000000,0.5192810829,0,6088000000,98000000,6186000000,54000000,6240000000,14692000000,-4000000,209000000,679000000,3585000000,0.2039017177,2906000000,0.1652826755,-209000000,2697000000,0.1533955181,686000000,2000000000,0.1137527016,1.27,1.25,1578000000,1599000000,https://www.sec.gov/Archives/edgar/data/77476/000119312511269425/0001193125-11-269425-index.htm,https://www.sec.gov/Archives/edgar/data/77476/000119312511269425/d219776d10q.htm
2011-06-11,PEP,USD,0000077476,2011-07-21,2011-07-21 09:15:36,2011,Q2,16827000000,7963000000,8864000000,0.526772449,0,6003000000,67000000,6070000000,40000000,6110000000,14073000000,20000000,199000000,664000000,3418000000,0.2031259286,2754000000,0.1636655375,-179000000,2575000000,0.1530278719,670000000,1885000000,0.112022345,1.19,1.17,1583000000,1605000000,https://www.sec.gov/Archives/edgar/data/77476/000119312511193147/0001193125-11-193147-index.htm,https://www.sec.gov/Archives/edgar/data/77476/000119312511193147/d10q.htm
2011-03-19,PEP,USD,0000077476,2011-04-28,2011-04-28 09:19:15,2011,Q1,11937000000,5447000000,6490000000,0.5436876937,0,4715000000,24000000,4739000000,25000000,4764000000,10211000000,17000000,180000000,539000000,2265000000,0.1897461674,1726000000,0.1445924437,-163000000,1563000000,0.1309374215,419000000,1143000000,0.0957527017,0.72,0.71,1583000000,1605000000,https://www.sec.gov/Archives/edgar/data/77476/000119312511113679/0001193125-11-113679-index.htm,https://www.sec.gov/Archives/edgar/data/77476/000119312511113679/d10q.htm
2010-12-25,PEP,USD,0000077476,2011-02-18,2011-02-18 16:57:00,2010,Q4,18155000000,8359000000,9796000000,0.5395758744,0,7263000000,263000000,7526000000,39000000,7565000000,15924000000,42000000,408000000,800000000,3031000000,0.1669512531,2231000000,0.1228862572,-359000000,1872000000,0.1031120903,511000000,1365000000,0.0751858992,0.85,0.85,1607000000,1607000000,https://www.sec.gov/Archives/edgar/data/77476/000119312511040427/0001193125-11-040427-index.htm,https://www.sec.gov/Archives/edgar/data/77476/000119312511040427/d10k.htm
2010-09-04,PEP,USD,0000077476,2010-10-07,2010-10-07 16:25:50,2010,Q3,15514000000,7008000000,8506000000,0.5482789738,0,5607000000,69000000,5676000000,30000000,5706000000,12714000000,18000000,169000000,631000000,3431000000,0.2211550857,2800000000,0.1804821452,-141000000,2659000000,0.17139358,729000000,1922000000,0.1238881011,1.21,1.19,1593000000,1618000000,https://www.sec.gov/Archives/edgar/data/77476/000119312510225896/0001193125-10-225896-index.htm,https://www.sec.gov/Archives/edgar/data/77476/000119312510225896/d10q.htm
2010-06-12,PEP,USD,0000077476,2010-07-20,2010-07-20 17:05:46,2010,Q2,14801000000,6745000000,8056000000,0.5442875481,0,5408000000,155000000,5563000000,32000000,5595000000,12340000000,2000000,172000000,594000000,3055000000,0.2064049726,2461000000,0.1662725492,-161000000,2300000000,0.1553949057,687000000,1603000000,0.108303493,1.0,0.98,1608000000,1634000000,https://www.sec.gov/Archives/edgar/data/77476/000119312510161855/0001193125-10-161855-index.htm,https://www.sec.gov/Archives/edgar/data/77476/000119312510161855/d10q.htm
2010-03-20,PEP,USD,0000077476,2010-04-23,2010-04-23 07:46:09,2010,Q1,9368000000,4463000000,4905000000,0.5235909479,0,3728000000,321000000,4049000000,16000000,4065000000,8528000000,6000000,154000000,372000000,1927000000,0.2057002562,1555000000,0.1659906063,-154000000,1401000000,0.1495516652,-33000000,1430000000,0.15264731,0.9,0.89,1582000000,1606000000,https://www.sec.gov/Archives/edgar/data/77476/000119312510090778/0001193125-10-090778-index.htm,https://www.sec.gov/Archives/edgar/data/77476/000119312510090778/d10q.htm
2009-12-26,PEP,USD,0000077476,2010-02-22,2010-02-22 16:19:59,2009,Q4,13297000000,6293000000,7004000000,0.5267353538,0,4949000000,0,4949000000,21000000,4970000000,11263000000,23000000,112000000,647000000,2681000000,0.2016244266,2034000000,0.1529668346,-14000000,2020000000,0.1519139656,583000000,1434000000,0.1078438746,0.9,0.9,1589000000,1589000000,https://www.sec.gov/Archives/edgar/data/77476/000119312510036385/0001193125-10-036385-index.htm,https://www.sec.gov/Archives/edgar/data/77476/000119312510036385/d10k.htm
2009-09-05,PEP,USD,0000077476,2009-10-08,2009-10-08 16:10:28,2009,Q3,11080000000,5181000000,5899000000,0.532400722,0,3649000000,0,3649000000,18000000,3667000000,8848000000,16000000,86000000,544000000,2776000000,0.2505415162,2232000000,0.2014440433,76000000,2308000000,0.2083032491,575000000,1717000000,0.1549638989,1.1,1.09,1558000000,1577000000,https://www.sec.gov/Archives/edgar/data/77476/000119312509205617/0001193125-09-205617-index.htm,https://www.sec.gov/Archives/edgar/data/77476/000119312509205617/d10q.htm
2009-06-13,PEP,USD,0000077476,2009-07-22,2009-07-22 16:05:51,2009,Q2,10592000000,4881000000,5711000000,0.5391805136,0,3507000000,0,3507000000,14000000,3521000000,8402000000,28000000,101000000,510000000,2700000000,0.2549093656,2190000000,0.2067598187,46000000,2236000000,0.211102719,568000000,1660000000,0.1567220544,1.07,1.06,1555000000,1572000000,https://www.sec.gov/Archives/edgar/data/77476/000119312509153099/0001193125-09-153099-index.htm,https://www.sec.gov/Archives/edgar/data/77476/000119312509153099/d10q.htm
2009-03-21,PEP,USD,0000077476,2009-04-22,2009-04-22 16:32:34,2009,Q1,8263000000,3744000000,4519000000,0.5468958006,0,2921000000,0,2921000000,10000000,2931000000,6675000000,0,98000000,333000000,1921000000,0.2324821493,1588000000,0.1921820162,-73000000,1515000000,0.1833474525,374000000,1135000000,0.1373593126,0.73,0.72,1555000000,1570000000,https://www.sec.gov/Archives/edgar/data/77476/000119312509084604/0001193125-09-084604-index.htm,https://www.sec.gov/Archives/edgar/data/77476/000119312509084604/d10q.htm
2008-12-27,PEP,USD,0000077476,2009-02-19,2009-02-19 16:40:23,2008,Q4,12729000000,6171000000,6558000000,0.5152015084,0,5317000000,7000000,5324000000,14000000,5338000000,11509000000,0,201000000,287000000,1500000000,0.1178411501,1213000000,0.0952942101,-194000000,1019000000,0.0800534213,293000000,719000000,0.0564851913,0.46,0.46,1578000000,1578000000,https://www.sec.gov/Archives/edgar/data/77476/000119312509033126/0001193125-09-033126-index.htm,https://www.sec.gov/Archives/edgar/data/77476/000119312509033126/d10k.htm
2008-09-06,PEP,USD,0000077476,2008-10-15,2008-10-15 16:46:57,2008,Q3,11244000000,5268000000,5976000000,0.5314834578,0,3972000000,7000000,3979000000,6000000,3985000000,9253000000,0,-142000000,519000000,2503000000,0.2226076129,1984000000,0.176449662,149000000,2133000000,0.189701174,550000000,1576000000,0.1401636428,1.01,0.99,1564000000,1593000000,https://www.sec.gov/Archives/edgar/data/77476/000119312508211024/0001193125-08-211024-index.htm,https://www.sec.gov/Archives/edgar/data/77476/000119312508211024/d10q.htm
2008-06-14,PEP,USD,0000077476,2008-07-23,2008-07-23 16:33:28,2008,Q2,10945000000,5078000000,5867000000,0.5360438556,0,3658000000,6000000,3664000000,12000000,3676000000,8754000000,0,-132000000,507000000,2692000000,0.245957058,2185000000,0.1996345363,138000000,2323000000,0.2122430333,618000000,1699000000,0.1552306989,1.07,1.05,1582000000,1612000000,https://www.sec.gov/Archives/edgar/data/77476/000119312508156305/0001193125-08-156305-index.htm,https://www.sec.gov/Archives/edgar/data/77476/000119312508156305/d10q.htm
